1111111111111111111111111111111111111111
1000000000000000000001111111111111111111
1011111111111111111111101111111111111111
1C000000000000000000000000000000000000P1
1111111111111111111111101111111111111111
10000000000000000000000011111111111111111
1011000001111111111111111111111111111111
1010000000001000100000001111111111111111
11011000001000100010001E1111111111111111
1111111111111111111111111111111111111111