111111111111
100100C0C0E1
100C01001111
100000001001
1100001000P1
100000000001
101010101011
111111111111